~.~~~~~~~~~~~~~~~~~~~~~~~~~~~~~~~~~~~~~~
~~.~~....~~~~~~~....~~~~~....~~~~~~~~~~~
~~~~~....~~~~~~~....~~~~~....~~~~~~~~~~~
~~~~~~~~~~~~~~~~~~~~~~~~~~~~~~~~~~~~~~~~
~~~~~~~~~~~~~~....~~~~~~~~~~~~~~....~~~~
~~~~~~~~~~~~~~....~~~~~~~~~~~~~~....~~~~
~~~~~~~~~~~~~~~~~~~~~~~~~~~~~~~~~~~~~~~~
~~~~~~~~~~~~~~~~~~~~~~~~~~~~~~~~~~~~~~~~
~~~~~....~~~~~~~....~~~~~....~~~~~~~~~~~
~~~~~....~~~~~~~....~~~~~....~~~~~~~~~~~
~~~~~~~~~~~~~~~~~~~~~~~~~~~~~~~~~~~~~~~~
~~~~~~~~~~~~~~....~~~~~~~~~~~~~~....~~~~
~~~~~~~~~~~~~~....~~~~~~~~~~~~~~....~~~~
~~~~~~~~~~~~~~~~~~~~~~~~~~~~~~~~~~~~~~~~
~~~~~~~~~~~~~~~~~~~~~~~~~~~~~~~~~~~~~~~~
~~~~~....~~~~~~~....~~~~~....~~~~~~~~~~~
~~~~~....~~~~~~~....~~~~~....~~~~~~~~~~~
~~~~~~~~~~~~~~~~~~~~~~~~~~~~~~~~~~~~~~~~
